11 22 11 21 11 90 11 22 10 21 11 20 11 20 10 20 10 20 11 21 10 21 11 21 11 20 11 22 11 20 11 21 11 22 11 22 11 22 10 21 11 20 10 22 11 22 11 21 11 20 11 22 11 20 11 20 10 20 11 21 10 22 11 21 11 20 11 20 11 21 10 22 11 22 11 21 11 20 11 22 11 22 10 20 10 20 11 22 11 21 11 22 11 21 11 92 10 21 11 20
22 11 21 11 21 80 21 11 22 11 22 11 20 11 20 10 21 11 22 11 20 11 22 11 21 11 21 10 22 10 20 11 21 11 22 11 20 11 20 10 21 11 21 11 21 10 20 11 21 10 20 11 21 11 21 11 20 11 20 11 21 10 20 11 20 11 22 10 20 10 21 11 20 11 20 11 20 10 20 11 22 11 21 10 22 11 22 11 22 10 22 11 22 11 21 81 21 10 21 11
10 21 10 21 10 92 11 20 11 22 11 20 11 20 10 21 11 20 11 20 11 22 10 21 10 20 11 22 10 22 11 20 11 21 11 21 10 22 10 20 11 22 11 22 11 22 11 20 10 21 10 22 11 22 11 21 11 20 11 22 10 20 11 21 11 20 11 21 11 22 11 21 11 21 11 21 11 21 10 22 10 21 11 20 11 21 11 20 10 22 10 22 11 21 10 92 11 22 10 21
22 11 22 11 22 81 21 11 22 11 21 11 20 11 21 10 20 11 22 11 22 11 21 11 22 11 20 11 22 10 20 11 22 11 22 11 21 10 22 11 21 11 20 11 21 11 22 10 22 10 20 11 22 10 22 11 20 11 20 10 22 11 21 11 22 11 21 11 22 11 21 11 21 11 21 10 22 11 20 11 20 11 21 11 22 11 21 11 21 11 20 11 22 11 20 80 21 11 21 11
10 22 10 21 11 91 11 22 11 22 11 20 11 20 10 21 10 22 11 20 10 22 11 22 11 22 10 22 11 22 11 22 11 21 10 20 11 22 11 22 10 20 10 20 10 22 11 21 11 21 11 22 11 20 10 22 10 22 11 22 10 20 11 20 10 21 11 22 10 21 11 21 11 22 10 22 11 22 11 20 11 22 11 22 11 20 11 21 11 21 11 20 11 22 11 91 10 22 11 21
20 11 20 11 21 81 22 11 22 11 22 11 21 10 21 11 20 11 22 10 21 11 20 11 21 11 20 11 20 11 22 11 22 10 22 11 21 10 21 11 22 11 20 11 20 10 20 11 21 10 21 11 22 10 21 11 20 11 21 11 22 10 20 11 22 10 22 11 22 10 20 10 22 11 22 11 21 11 22 11 21 10 21 11 22 10 21 10 20 11 22 11 20 11 22 81 21 11 22 11
11 20 11 21 10 91 10 21 10 20 10 22 11 20 10 20 11 20 10 20 11 22 10 22 11 21 11 22 11 22 11 20 11 22 11 22 11 21 11 20 11 21 11 20 11 20 11 20 11 22 11 21 10 21 11 20 10 22 10 20 11 21 10 20 11 21 10 20 11 20 10 22 10 20 11 20 11 21 11 20 10 21 10 20 10 22 11 22 10 22 11 21 11 22 11 91 11 21 11 20
20 11 22 10 22 80 20 10 22 10 21 11 20 11 22 10 22 10 21 10 20 11 22 11 20 10 21 11 21 11 22 11 20 10 20 11 22 10 22 11 20 10 22 11 21 10 20 11 22 11 20 10 21 11 21 11 22 11 22 10 22 10 21 11 20 11 20 10 21 11 21 10 21 10 20 10 22 11 21 11 22 11 22 11 21 10 21 11 20 11 20 11 20 11 20 80 20 10 21 11
81 91 81 90 81 90 81 90 80 91 80 90 80 91 80 91 81 90 80 92 81 92 80 90 80 92 81 92 80 91 80 92 81 90 80 91 81 91 80 92 81 90 80 92 81 92 81 92 80 91 81 90 81 90 81 91 80 90 81 90 81 90 80 92 81 91 80 92 81 92 81 90 80 90 81 91 81 90 80 92 81 91 81 90 81 90 80 91 81 92 80 91 80 91 81 91 81 92 80 90
20 11 22 11 20 81 20 11 21 10 20 11 20 11 20 11 21 11 20 10 22 10 20 11 20 10 22 10 20 11 20 11 21 11 20 10 22 10 21 11 21 10 21 10 22 11 21 11 21 11 21 11 22 11 22 11 20 11 21 10 21 11 21 11 22 10 21 11 22 11 22 11 22 11 21 11 20 11 21 11 22 11 21 11 21 11 20 10 22 11 21 11 22 10 21 80 20 11 22 11
10 21 11 20 11 90 11 21 10 20 11 22 11 22 11 21 11 21 10 20 11 22 10 22 11 22 11 22 11 20 10 20 11 20 10 21 11 21 11 21 10 20 11 21 11 22 11 20 10 22 11 21 11 20 11 20 10 22 11 21 11 21 10 20 11 20 11 22 10 20 11 20 11 20 10 20 11 22 10 20 10 20 10 21 11 22 11 21 10 20 11 20 11 22 11 91 11 22 11 22
20 11 21 10 21 80 21 11 21 11 21 10 20 11 21 11 22 10 20 11 22 11 20 11 21 11 22 11 20 10 22 11 22 11 21 11 20 11 21 11 21 11 22 11 21 11 21 10 21 11 22 11 20 11 20 10 22 11 22 10 22 11 21 10 21 11 22 10 20 11 21 10 21 11 20 11 20 11 20 11 21 11 20 10 22 11 20 10 20 10 20 10 22 11 21 81 21 10 22 11
10 20 10 20 10 90 11 20 10 21 11 21 10 21 11 22 11 22 11 22 10 20 11 20 10 21 11 22 11 20 11 22 10 22 10 22 11 20 11 20 10 22 11 21 10 21 10 22 11 22 11 20 11 20 10 22 11 21 11 21 10 22 11 20 11 21 11 21 10 21 11 21 11 20 11 20 11 22 11 22 11 20 11 22 10 22 11 21 10 21 11 21 11 22 10 91 10 21 11 21
21 10 22 11 22 80 22 10 21 10 20 11 20 11 21 11 22 11 20 11 22 10 20 10 20 11 22 11 21 10 20 11 20 11 20 11 21 11 22 10 21 11 20 11 22 11 22 10 22 11 20 11 22 10 21 10 20 11 20 11 22 10 21 11 21 11 22 11 20 10 20 11 22 11 22 11 21 11 22 10 21 10 22 10 22 11 21 11 22 11 20 11 20 11 20 81 21 11 20 11
11 22 10 21 10 91 10 21 10 22 11 21 11 20 11 20 10 21 10 20 11 21 11 20 10 21 11 20 11 20 11 22 11 21 11 22 10 21 11 20 11 22 11 21 10 22 11 21 10 21 10 20 11 20 10 22 11 20 11 20 11 20 10 22 11 22 11 20 11 20 11 22 11 22 11 20 10 20 11 21 10 22 11 21 11 21 10 20 11 21 10 21 10 21 11 91 11 22 10 22
21 11 22 11 22 81 20 11 22 10 22 11 20 10 21 11 22 10 22 11 22 10 20 11 22 11 21 11 20 10 21 11 22 11 22 11 20 10 22 11 20 11 20 11 21 11 22 10 21 10 22 11 22 11 22 10 20 11 22 11 21 11 20 11 22 10 22 10 21 10 20 11 21 11 21 10 21 10 20 10 21 10 21 11 20 10 20 11 20 11 22 11 22 10 20 80 22 11 21 10
10 21 10 22 10 90 11 22 10 22 11 20 11 21 11 20 11 21 10 20 11 20 10 20 10 21 10 21 11 21 11 22 11 21 10 20 11 22 11 20 10 20 10 21 10 22 10 21 11 21 10 22 11 20 11 21 10 22 10 21 11 21 11 22 11 22 10 20 10 22 10 20 10 22 10 20 11 20 11 20 11 21 11 20 10 22 10 21 10 20 11 20 11 21 11 92 10 21 11 21
22 11 21 11 22 80 22 10 20 11 20 11 21 11 20 11 20 10 21 10 22 11 22 11 21 11 21 10 21 11 21 10 21 10 21 11 20 10 21 11 20 11 22 10 21 10 20 11 22 10 21 10 22 11 20 11 20 11 21 11 21 10 22 10 20 11 21 10 21 11 22 10 22 11 22 10 20 11 20 11 20 11 21 11 20 11 22 11 22 11 22 11 22 10 21 81 22 11 20 11
11 21 10 22 11 91 11 21 10 21 11 21 11 22 11 22 11 20 11 21 10 21 11 21 11 21 10 22 10 20 11 22 11 21 11 20 11 21 11 20 10 21 10 20 11 22 11 22 11 22 11 22 11 20 10 22 11 22 11 22 11 20 10 20 11 22 11 22 11 20 11 20 11 22 11 22 11 22 10 21 10 20 10 21 11 20 11 22 11 20 11 22 10 21 10 91 10 21 11 22
22 10 22 11 22 81 21 11 22 10 20 11 22 10 21 11 21 11 20 11 22 11 21 10 22 10 22 11 22 10 20 11 20 11 20 11 22 11 21 11 20 10 22 11 22 11 22 11 21 10 21 10 22 11 22 10 22 11 22 11 21 10 21 10 22 11 21 10 20 11 22 10 21 10 21 11 21 10 22 11 20 11 22 10 21 11 22 11 20 10 21 11 22 11 21 81 22 11 20 11
11 21 11 21 10 92 11 20 11 20 10 20 10 20 11 20 11 22 11 22 11 21 11 22 10 20 10 20 11 21 10 20 11 22 10 22 10 22 10 22 11 22 11 20 10 20 10 20 11 22 11 21 10 20 10 21 11 21 11 21 11 22 11 20 10 21 11 21 11 21 10 22 11 22 11 20 11 20 10 22 11 21 11 21 11 22 11 20 11 20 11 20 11 20 11 90 10 22 11 21
20 10 21 10 21 80 21 11 21 11 22 11 21 10 20 11 21 11 21 10 20 11 22 10 20 11 21 10 20 11 22 10 22 11 21 11 22 10 21 11 21 10 22 10 20 10 21 11 20 11 20 11 22 11 21 10 22 11 22 10 22 11 22 11 22 10 22 10 22 11 22 10 20 11 21 11 22 11 20 11 21 10 22 10 21 11 22 11 20 10 21 11 20 10 20 80 20 11 20 11
10 21 11 21 11 91 11 21 10 20 11 22 11 21 11 20 10 21 11 22 10 20 11 21 11 21 10 20 10 21 10 21 11 20 10 20 11 22 11 21 10 20 11 22 10 22 11 22 11 20 11 20 11 21 11 21 10 21 10 22 11 21 10 22 11 21 10 22 11 22 11 20 10 22 11 20 11 21 11 20 11 22 10 22 10 21 11 20 10 22 10 22 11 22 11 90 10 20 11 21
22 11 20 11 22 81 20 11 20 10 20 11 22 11 20 11 20 11 21 10 22 11 20 11 21 11 22 10 22 11 21 11 20 10 20 11 22 11 20 11 20 11 20 11 22 11 21 11 20 11 20 10 22 11 20 10 20 10 20 11 22 11 20 10 20 11 22 10 22 10 20 11 21 10 22 11 21 11 22 11 21 10 21 11 20 11 22 10 20 10 20 11 21 11 22 80 21 11 21 11
11 22 11 22 11 91 10 20 11 21 11 20 11 20 10 22 11 21 11 21 11 20 10 22 10 20 11 21 11 22 10 22 11 21 10 21 11 22 11 22 10 21 10 20 11 21 11 21 11 20 11 21 11 21 11 20 11 20 11 22 11 20 11 21 10 21 10 20 11 20 10 20 10 21 10 21 11 20 11 21 11 20 10 20 10 22 11 20 10 20 11 22 10 22 11 91 10 22 11 22
22 11 21 11 21 81 20 11 22 10 21 10 22 11 21 10 22 10 21 11 21 11 20 11 21 10 20 10 20 11 22 11 22 11 21 11 20 11 22 11 22 10 21 10 22 11 22 11 21 11 21 11 22 10 22 11 20 10 22 10 21 10 22 10 21 11 20 10 21 11 22 10 22 11 20 10 20 10 20 10 20 10 20 10 21 10 20 11 21 11 22 11 20 11 21 80 21 10 22 11
10 21 10 20 10 90 11 21 10 20 10 22 11 22 11 20 11 21 11 22 11 21 10 20 11 22 10 22 11 22 10 21 11 20 11 22 11 20 11 20 11 22 11 22 11 22 11 20 11 22 11 22 10 20 10 22 11 22 11 22 10 21 11 21 11 22 11 22 11 21 11 22 11 20 10 22 11 22 11 22 10 20 10 22 11 22 11 21 11 22 11 21 11 21 10 91 11 20 11 21
22 11 22 11 20 80 21 11 21 11 20 10 22 10 21 11 22 11 22 11 20 10 20 11 21 10 21 10 20 10 21 11 21 10 21 11 21 11 21 11 22 11 20 10 22 11 20 11 21 10 21 11 22 10 22 10 20 11 21 11 21 11 20 10 22 10 20 11 21 11 20 10 22 11 22 10 22 11 22 10 20 10 21 11 20 10 22 10 21 10 21 10 20 11 22 81 22 11 21 10
10 20 10 20 11 92 10 21 10 20 10 20 11 20 11 20 11 22 10 21 10 22 11 20 10 21 11 20 10 22 10 20 10 22 11 21 11 22 11 22 10 20 11 22 11 22 11 21 10 20 11 20 11 21 11 21 11 21 11 20 10 20 11 22 11 21 10 21 10 22 10 20 11 20 10 21 11 21 11 21 11 21 11 21 11 22 10 21 11 22 11 22 10 20 11 90 10 20 10 21
20 11 21 10 21 81 22 11 20 11 21 11 21 11 21 10 20 10 20 11 21 11 22 11 22 11 20 10 20 11 20 11 22 10 20 11 21 11 21 11 20 11 21 11 20 11 20 10 20 10 22 10 20 11 20 10 21 11 22 10 22 10 22 11 21 11 20 11 20 10 21 11 21 10 21 11 21 10 20 11 22 11 21 11 20 10 22 11 22 11 22 11 22 11 22 81 21 11 21 11
11 21 10 20 10 91 10 20 11 22 11 20 11 21 10 20 11 22 11 20 11 21 11 22 11 22 11 21 11 21 11 22 11 22 11 22 11 20 11 21 11 20 11 21 10 20 10 21 10 22 11 22 10 21 11 22 11 21 11 21 11 21 10 22 11 22 11 22 11 20 11 20 11 20 10 21 11 21 10 20 10 21 11 20 11 20 10 20 11 21 11 22 10 21 10 91 10 22 10 20
20 11 22 11 22 81 21 11 20 11 21 11 20 11 21 10 21 10 20 11 20 11 21 11 20 10 22 11 22 10 21 11 21 11 22 11 20 10 22 10 22 10 20 11 21 11 21 10 21 10 21 11 21 10 20 11 21 10 21 10 22 11 20 11 21 11 21 11 20 11 22 11 22 11 21 10 21 10 20 11 20 11 22 11 20 11 21 10 21 11 20 10 22 11 22 80 20 11 21 11
11 22 11 20 10 92 11 22 11 21 11 22 11 22 11 21 11 20 11 21 10 21 11 20 10 20 11 21 11 21 11 20 11 21 11 20 11 21 11 22 10 22 11 20 10 20 10 22 10 22 11 22 10 21 11 22 10 21 11 20 11 20 10 22 11 22 10 22 11 21 11 20 11 21 11 20 11 21 11 22 10 22 11 22 10 21 10 22 11 22 10 21 11 22 11 92 11 20 10 21
21 11 20 11 20 81 20 11 20 10 21 11 21 10 20 11 22 11 21 11 20 10 22 11 21 10 21 11 21 10 22 11 21 10 20 11 22 10 21 11 20 10 21 11 22 10 20 11 22 10 20 11 22 10 21 11 21 11 22 10 21 11 22 11 20 10 21 10 22 11 22 11 22 11 21 11 21 11 22 11 21 11 20 11 20 10 21 11 21 11 21 11 21 10 21 81 22 10 20 10
10 20 10 20 10 90 10 20 11 21 11 20 10 20 11 20 10 22 10 21 11 21 11 21 11 22 11 22 11 22 11 22 11 20 10 22 10 22 11 21 11 22 11 22 11 22 11 20 11 22 11 21 11 22 10 22 11 21 11 21 11 22 11 20 11 21 10 20 10 20 11 22 11 20 11 22 11 20 11 21 11 22 11 22 11 22 11 20 11 21 11 22 11 22 11 92 10 21 11 22
20 11 20 11 21 80 22 11 20 11 22 11 22 11 21 11 22 11 20 10 21 10 22 11 21 11 20 10 21 10 20 11 21 10 22 11 20 10 22 10 22 11 21 10 21 11 22 11 20 11 22 10 21 11 22 11 21 11 21 10 22 11 22 11 22 11 20 10 22 10 22 10 20 11 22 11 21 10 20 10 20 11 21 11 20 10 20 11 21 11 20 10 20 10 20 81 22 11 22 11
11 21 11 22 11 92 10 21 11 20 10 21 11 22 10 20 11 20 10 22 10 22 11 21 11 21 11 20 10 20 11 20 11 21 10 21 10 21 11 20 11 20 10 21 10 21 11 22 11 21 10 22 10 20 11 22 11 20 10 22 11 21 11 21 11 20 11 20 10 21 10 21 11 20 11 22 11 22 11 22 10 21 11 20 11 20 11 21 10 20 11 20 11 20 10 90 11 20 10 22
21 10 20 10 20 81 20 11 20 10 21 11 20 11 21 11 21 11 20 11 20 11 21 11 20 10 21 11 21 11 22 10 20 10 21 11 22 11 21 11 22 11 21 10 22 11 21 10 21 11 22 10 21 11 21 11 22 11 20 11 21 11 22 11 20 10 22 11 21 11 20 11 22 10 20 10 22 11 21 10 20 11 22 11 22 11 22 11 20 11 22 11 21 11 22 81 22 11 22 11
10 22 11 21 11 92 11 22 11 21 11 21 11 21 11 22 11 21 11 20 11 22 10 22 11 22 11 20 11 20 11 22 11 21 10 21 10 20 10 21 11 21 11 20 10 20 11 20 10 20 11 20 10 20 11 22 11 22 10 20 10 20 11 20 10 22 11 21 11 22 10 20 11 22 11 22 11 21 10 21 11 21 11 20 11 20 11 20 11 22 10 21 11 20 10 92 10 22 10 21
22 10 21 11 22 81 20 11 22 10 22 10 21 10 21 11 21 10 20 11 20 11 21 10 20 11 20 11 22 11 20 11 20 11 21 10 21 11 22 11 22 11 20 11 21 11 20 11 20 10 22 11 20 11 21 11 21 11 21 10 21 10 22 10 22 11 22 11 20 11 22 11 20 11 21 11 20 11 21 10 20 10 21 11 21 10 21 11 22 10 20 10 22 11 22 81 20 11 20 11
10 20 10 22 11 92 10 20 11 22 11 21 11 21 11 21 11 21 11 21 10 21 10 20 11 21 10 22 11 22 10 22 11 21 11 20 11 21 11 22 11 22 11 22 11 21 10 20 11 20 11 20 11 22 10 22 11 22 11 20 11 20 11 20 11 20 10 22 10 21 10 20 10 21 11 20 10 21 10 20 10 21 10 21 11 22 11 22 11 22 11 20 11 22 11 92 11 21 11 21
20 10 21 11 22 81 21 11 21 11 22 11 21 11 21 11 20 11 21 11 20 11 21 11 21 11 21 11 21 11 21 11 21 10 21 11 21 11 22 11 21 10 22 10 22 10 22 10 20 10 20 10 21 11 21 11 22 10 20 10 22 11 20 11 21 10 20 10 20 11 22 10 20 11 21 11 20 11 22 11 20 10 21 11 20 10 20 11 20 11 20 10 20 11 21 81 20 11 22 11
81 91 80 90 80 90 81 92 81 90 81 90 80 92 81 92 80 92 81 91 81 90 81 90 81 91 81 91 81 90 81 92 80 91 81 91 81 92 81 92 81 91 81 92 80 90 81 91 81 91 81 92 81 90 81 91 81 91 81 91 81 90 81 91 81 90 81 90 81 90 80 90 81 92 80 91 81 92 80 90 81 90 81 91 81 90 80 91 81 90 81 92 80 90 81 92 81 92 80 92
22 11 21 11 22 80 22 11 22 10 21 11 20 11 22 11 22 11 21 11 21 10 20 10 21 11 22 11 20 10 22 11 22 11 21 10 22 10 21 11 21 11 22 10 20 11 22 10 22 10 22 10 20 11 22 10 21 10 20 10 20 11 21 10 22 10 20 11 21 10 21 10 21 11 20 10 21 11 22 10 22 11 20 11 21 11 21 11 21 10 20 11 22 10 20 81 22 11 22 10
11 22 11 21 11 91 10 21 10 21 11 20 10 20 11 20 11 21 10 21 10 21 11 20 11 22 11 21 10 20 11 22 11 21 11 21 11 21 11 20 11 20 11 20 11 22 10 21 10 21 10 22 10 20 10 20 10 22 11 20 10 22 10 20 10 22 11 22 11 20 11 22 11 22 10 20 11 21 11 22 11 21 11 21 11 21 11 20 10 22 11 21 11 20 11 91 11 21 11 20
22 10 22 11 22 81 20 11 22 11 21 11 21 10 20 10 20 11 22 10 21 11 22 11 21 11 20 11 21 10 20 11 22 10 20 11 22 10 22 10 22 11 22 10 21 11 21 10 20 10 20 11 21 11 21 11 22 11 21 10 22 11 22 10 21 11 21 11 20 10 20 11 21 11 20 10 21 11 21 11 22 10 20 11 20 10 21 11 22 11 21 11 20 11 22 81 20 11 22 11
11 22 10 21 10 90 11 20 11 21 11 22 11 20 11 20 10 21 11 22 11 21 11 20 11 21 11 21 11 22 11 20 10 21 11 20 10 20 11 22 10 20 10 20 11 21 11 22 11 22 11 20 11 20 11 22 11 20 11 21 11 21 11 21 11 20 10 22 11 22 11 21 11 21 10 21 10 21 11 22 11 21 11 21 11 20 10 22 11 20 11 21 10 21 11 91 11 20 11 21
22 11 22 10 22 81 22 11 21 10 20 11 22 11 21 11 20 10 22 11 22 11 22 11 22 11 21 11 21 11 20 11 22 11 20 10 22 10 20 10 22 11 21 11 20 11 20 11 22 11 20 11 22 10 22 11 21 11 20 11 20 11 22 11 20 11 22 11 21 10 21 11 20 10 20 11 22 10 20 11 22 11 21 10 21 10 21 11 20 11 21 10 20 11 21 80 21 11 22 11
11 22 11 22 10 92 11 22 10 20 11 22 10 20 10 21 11 20 10 20 10 22 10 20 11 22 11 20 11 21 11 21 11 21 10 22 11 22 10 22 11 20 11 20 11 22 11 20 10 20 11 21 11 21 11 20 11 21 11 22 11 20 10 21 11 20 11 20 11 21 11 21 10 21 11 22 10 20 11 20 10 22 11 22 11 21 11 20 11 22 11 21 11 22 10 91 10 22 10 21
22 11 22 10 20 81 21 11 22 11 20 11 22 10 20 11 20 10 22 11 22 11 22 11 22 11 21 11 20 11 22 10 22 11 21 11 20 11 22 10 22 11 20 11 22 11 21 11 20 11 20 10 21 11 22 10 21 10 22 11 20 11 21 11 22 11 21 11 21 10 22 10 21 11 20 11 22 11 22 11 21 11 22 11 22 10 21 11 20 11 20 11 21 10 20 81 21 11 21 11
