__________________________________________________________________________________________________
____1111__1111111111111111111111111111__111111_________1111__1111111111111111111111111111__111111_
____1111__111111111_1__1111__111111111111111111_________1111__1111111111111111111111111111__111111
____1111__11111111111111___11111111111__111111_______1111__1111111111111111111111111111__111111___
____1111__11_____1111111111111__111111__111111_______1111__1111111111111111111111111111__111111___
____1111__1_11111_1111111____1_1111111__111111_______1111__1111111111111111111111111111__111111___
____1111__1111111111111111111111111111__111111_______1111__1111111111111111111111111111__111111___
____1111______11__111111_1111111111111__111111_______1111__1111111111111111111111111111__111111___
____1111__1111111_111111_11111___11111__111111_______1111__1111111111111111111111111111__111111___
____1111__111__1___1111111111111111111__111111_______1111__1111111111111111111111111111__111111___
____1111__________111111_1111111111111__111111_______1111__1111111111111111111111111111__111111___
____1111__111111_111111111111111111111__111111_______1111__1111111111111111111111111111__111111___
____1111__111111_11111_1__111111111111__111111_______1111__1111111111111111111111111111__111111___
____1111__111111_111111111111111111111__111111_______1111__1111111111111111111111111111__111111___
____1111__111111___1111111111111111111__111111_______1111__1111111111111111111111111111__111111___
_____111__111111___1111111111111111111111111111111111111111111111111111111111111111111111111111___
____1111__111111_111111111111111111111__111111_______1111__1111111111111111111111111111__111111___
____1111__111111_111111111111111111111__111111_______1111__1111111111111111111111111111__111111___
____1111__111111__11111111111111111111__111111_______1111__1111111111111111111111111111__111111___
____1111__111111__11111111111111111111__111111_______1111__1111111111111111111111111111__111111___
____1111__111111__11111111111111111111__111111_______1111__1111111111111111111111111111__111111___
____1111__________11111111111111111111__111111_______1111__1111111111111111111111111111__111111___
____1111__1111111111111111111111111111__111111_______1111__1111111111111111111111111111__111111___
____1111__1111111111111111111111111111__111111_______1111__1111111111111111111111111111__111111___
____1111__1111111111111111111111111111__111111_______1111__1111111111111111111111111111__111111___
____1111__1111111111111111111111111111__111111_______1111__1111111111111111111111111111__111111___
____1111__1111111111111111111111111111__111111_______1111__1111111111111111111111111111__111111___
__________________________________________________________________________________________________


