11 20 11 21 11 20 11 20 11 20 10 22 10 22 11 22 11 21 11 21 11 22 11 21 11 20 10 21 10 21 11 20 10 21 11 21 11 21 10 21 10 22 11 22 11 22 10 21 11 20 11 22 10 22 11 22 11 22 11 20 11 20 10 21 11 21 10 21 11 21 11 21 10 21 11 21 10 22 11 22 10 22 11 22 11 22 11 21 10 22 10 22 11 21 11 21 11 22 11 21
21 11 20 10 20 11 22 11 20 11 21 10 20 11 20 11 21 11 22 11 21 10 21 11 22 10 20 11 21 11 22 11 21 11 20 11 20 11 22 11 20 10 20 10 20 10 20 11 22 10 21 11 22 11 20 11 21 11 20 11 21 10 22 10 21 11 21 10 21 10 22 11 22 11 20 10 20 11 21 11 22 11 22 11 20 11 22 11 20 11 20 11 20 11 21 11 21 10 21 10
10 21 11 22 10 22 11 21 11 20 11 22 11 20 11 22 11 20 11 22 11 20 11 21 11 20 10 22 10 21 11 20 10 20 11 22 11 21 11 22 11 22 11 22 10 22 11 21 11 20 10 22 10 21 10 21 10 20 11 21 11 22 10 20 10 20 11 21 11 21 10 21 11 20 11 21 10 22 11 21 10 22 10 21 10 22 11 21 11 20 11 20 11 20 11 21 10 22 11 21
22 10 21 11 20 11 21 10 22 11 21 10 21 11 21 11 22 11 20 11 20 11 22 10 20 10 21 11 21 11 20 10 21 10 21 11 20 10 21 10 20 10 21 10 21 11 21 11 21 11 22 10 22 11 22 11 20 11 21 11 20 11 22 11 20 10 22 11 22 11 22 11 21 11 20 11 22 11 21 11 20 11 21 11 21 10 22 10 21 11 20 11 22 11 21 10 21 11 20 11
10 21 11 20 11 21 11 21 10 22 10 22 11 21 11 20 10 20 11 20 11 22 11 22 10 21 11 20 10 21 10 20 10 21 10 21 11 21 11 22 11 20 11 20 11 20 11 20 11 20 11 22 11 22 11 22 10 22 11 20 11 22 11 22 11 21 11 21 11 21 11 22 11 20 11 21 11 20 11 20 11 22 10 21 11 22 11 20 11 20 11 21 11 22 10 21 10 22 11 22
20 11 21 11 22 11 22 11 20 11 20 10 21 11 21 11 20 10 21 11 20 10 21 10 20 10 21 11 20 11 22 11 22 11 22 10 22 11 21 10 20 11 21 10 21 11 20 11 22 10 20 11 20 10 20 11 20 10 20 11 21 10 21 11 21 11 22 10 20 10 21 11 20 10 20 11 22 11 22 11 22 11 22 11 21 11 21 11 21 11 22 10 22 11 22 11 22 10 20 10
10 20 11 21 11 21 10 22 11 21 11 22 11 20 10 22 10 22 11 22 11 20 11 20 11 22 11 20 11 21 11 21 11 22 10 21 11 21 10 20 11 22 11 22 11 21 11 21 11 20 11 20 10 20 11 21 11 22 10 21 11 20 11 21 10 22 10 22 11 21 11 21 11 20 10 21 10 21 10 20 11 22 10 22 11 22 11 20 11 21 11 21 10 20 11 20 10 22 11 20
20 11 20 11 20 11 21 11 20 10 20 11 22 10 22 11 22 11 20 11 21 11 21 10 22 11 22 11 20 10 20 11 21 11 21 11 22 11 20 11 22 11 21 10 22 11 22 10 20 11 22 10 21 11 21 11 20 11 22 11 20 10 22 11 22 11 21 11 21 10 21 10 20 10 20 10 20 11 20 11 21 10 20 10 21 10 21 11 22 11 20 11 20 11 20 11 22 10 20 11
11 22 11 20 11 20 11 21 11 21 11 22 10 21 11 22 10 22 11 20 10 22 11 22 11 20 10 20 11 20 11 20 11 20 11 20 10 21 11 20 11 21 10 20 10 20 10 21 11 22 11 20 11 20 11 20 11 21 11 20 10 22 11 22 11 20 11 22 11 21 11 21 11 20 10 22 11 21 11 22 10 21 10 22 11 22 11 20 10 22 11 22 11 20 10 21 10 21 11 20
21 10 20 11 21 11 20 10 21 11 22 11 22 10 21 10 20 11 20 11 20 11 21 11 21 11 22 11 21 11 22 10 21 10 21 11 22 11 21 11 20 11 22 10 21 11 20 11 22 11 21 11 22 11 21 10 22 10 20 11 20 10 20 10 21 11 21 11 20 10 22 11 22 10 21 11 20 11 21 10 21 11 20 11 20 11 20 10 22 10 21 11 22 10 22 10 21 11 20 11
11 22 10 21 11 20 11 21 11 21 11 22 10 21 11 20 11 20 11 21 10 21 10 21 10 22 11 21 10 22 10 21 11 22 11 21 10 22 10 22 11 22 10 20 10 22 11 21 10 20 11 21 11 21 11 22 11 22 11 20 10 21 11 21 11 20 11 21 11 22 10 20 11 20 10 22 10 22 10 21 11 22 10 20 11 20 11 22 10 21 10 22 11 20 11 22 11 21 10 20
20 11 22 10 21 11 22 10 22 11 21 11 20 11 20 10 21 10 21 10 21 11 20 11 22 11 20 11 21 11 20 10 22 11 21 11 20 11 21 11 20 11 21 11 20 11 20 10 21 11 22 11 22 11 22 11 20 11 20 11 22 11 20 10 20 10 22 11 20 11 21 10 21 11 21 11 20 11 20 10 21 10 22 10 22 11 22 11 22 11 22 11 20 11 21 10 22 11 20 11
10 20 11 20 11 21 11 21 11 22 11 21 11 22 10 20 10 20 11 21 11 20 11 22 10 20 10 20 11 22 11 20 10 22 11 20 11 22 11 22 10 20 11 22 11 21 11 20 11 20 11 20 11 20 11 21 11 21 11 20 11 22 10 20 11 21 10 21 10 22 11 20 11 20 11 21 10 22 11 22 10 21 11 22 11 20 11 22 11 22 11 21 11 22 11 21 11 22 11 21
22 10 20 11 20 10 22 11 21 10 20 10 20 11 21 11 20 11 22 11 20 10 21 10 22 11 20 10 22 10 22 11 20 11 21 11 20 11 22 10 20 11 21 11 21 10 22 11 21 10 22 10 21 10 21 10 22 11 20 11 20 11 20 10 22 11 20 11 22 11 20 11 21 11 22 11 22 11 20 11 20 10 20 10 21 10 20 11 22 10 21 10 22 10 21 10 21 11 20 11
10 22 10 21 10 22 11 21 11 22 11 20 11 22 11 21 11 21 11 20 11 22 11 20 10 20 11 21 11 20 10 20 10 22 11 21 10 21 11 21 11 20 11 22 10 21 11 20 10 22 11 20 11 20 10 22 11 20 11 20 11 22 11 22 11 22 11 21 10 21 11 20 10 21 10 20 11 22 10 22 11 21 11 21 11 22 10 21 11 22 11 20 11 21 10 20 10 21 11 21
22 11 20 11 20 11 22 11 20 11 22 10 22 10 20 10 21 11 21 10 21 11 22 11 22 11 22 11 22 11 22 11 21 10 21 10 20 11 21 10 20 11 22 11 21 11 22 11 20 11 22 11 20 10 22 10 21 11 22 11 21 11 20 10 21 11 22 11 20 10 22 11 20 11 21 11 20 10 21 11 20 11 22 10 20 11 21 10 22 11 20 10 22 11 20 11 22 11 21 10
11 22 11 22 11 22 10 22 10 20 10 22 11 20 10 21 11 21 11 21 11 20 11 20 11 20 10 20 10 21 11 22 11 22 10 20 11 20 11 20 11 22 11 21 11 21 11 21 10 22 10 22 11 21 10 20 10 21 10 22 11 21 10 20 10 20 11 20 11 22 11 20 10 21 11 21 11 22 11 21 11 22 11 21 10 20 10 20 11 22 11 21 11 21 11 20 11 20 11 20
22 11 21 11 22 11 20 10 21 11 20 11 20 11 22 11 20 10 21 11 21 11 22 11 21 11 21 10 20 11 20 11 21 11 22 10 22 11 22 11 20 10 22 11 20 10 22 11 20 11 21 10 20 10 22 11 21 11 22 11 21 11 22 10 21 11 21 10 21 11 21 11 20 11 20 11 21 11 22 11 20 11 20 11 21 11 20 11 22 10 20 11 22 11 21 11 20 10 21 11
10 22 11 20 11 21 10 21 11 20 10 21 10 22 11 21 11 20 10 21 11 20 11 22 11 22 10 22 11 22 11 20 10 20 10 20 11 22 11 22 10 20 11 20 10 22 11 22 11 22 10 20 11 21 10 20 10 20 11 21 10 20 10 21 10 21 10 21 10 20 11 20 11 22 10 21 11 20 11 22 11 20 11 20 11 21 10 21 10 21 11 20 11 20 11 22 10 21 10 21
22 11 21 11 21 11 21 10 21 11 22 11 21 11 20 11 22 11 22 10 21 11 20 11 21 11 21 10 22 11 22 11 20 11 21 11 21 11 20 11 20 10 20 11 21 10 20 11 22 11 22 10 20 11 21 11 20 11 21 10 21 10 20 11 22 10 20 10 20 10 22 10 22 11 20 11 22 11 22 11 20 11 22 10 21 11 22 10 20 11 22 10 21 10 22 11 21 11 22 11
10 21 10 22 11 21 11 20 11 22 10 21 11 20 10 20 10 20 10 22 11 20 11 21 11 20 11 22 10 21 11 20 11 21 10 22 11 20 10 22 10 22 10 20 11 21 11 22 10 21 10 22 10 20 11 22 11 22 11 22 10 22 11 22 11 22 10 22 11 20 11 20 10 21 11 21 10 21 11 20 11 20 11 21 11 20 11 20 10 22 10 20 11 21 10 22 11 21 11 22
21 10 20 10 20 11 21 10 20 11 22 11 22 10 20 11 20 10 21 11 20 11 22 11 22 11 22 11 21 11 21 10 21 10 22 11 22 10 22 10 21 10 20 11 20 10 20 11 21 11 20 11 20 11 20 11 20 11 20 11 21 10 21 11 20 10 20 10 20 11 20 11 20 10 20 10 22 11 22 10 20 11 20 10 21 11 20 11 21 10 22 11 21 11 21 10 21 11 21 11
11 22 11 22 11 20 11 21 10 20 11 21 10 21 11 20 10 20 10 20 10 22 11 21 11 22 11 22 10 22 11 21 11 20 11 20 11 22 11 22 11 22 11 21 10 20 10 21 11 22 10 20 11 20 10 22 11 22 11 20 11 21 11 22 10 21 10 22 11 21 11 22 11 22 11 22 10 21 11 21 11 21 10 22 11 20 10 20 10 20 10 21 10 21 11 21 11 21 11 21
21 10 22 11 21 11 21 11 21 11 21 11 22 10 21 11 21 10 22 10 20 10 21 10 20 11 21 11 21 11 20 10 21 11 21 11 22 11 20 11 21 11 20 11 22 11 21 11 20 11 22 10 22 10 20 11 21 10 22 11 20 10 21 11 20 11 21 11 20 11 20 10 22 10 22 11 22 11 22 11 22 10 21 10 21 11 21 10 20 11 22 11 20 10 20 11 20 10 21 11
11 22 10 22 11 20 11 21 11 20 11 21 11 20 11 22 11 21 10 22 11 22 10 20 11 22 10 22 11 20 10 22 11 22 10 20 11 22 11 21 10 20 11 22 11 20 11 20 11 22 10 21 10 21 10 21 11 20 11 22 11 20 11 22 10 20 10 21 10 21 10 20 10 22 11 20 10 20 10 21 11 22 10 22 10 22 11 20 10 22 11 22 11 21 11 20 11 20 11 21
22 11 22 10 21 11 21 10 20 11 22 11 20 11 22 11 20 11 21 11 21 11 22 10 22 10 20 11 22 11 21 11 20 10 22 11 22 11 22 10 21 11 21 11 20 10 21 11 22 10 22 10 22 11 20 11 21 10 21 11 21 11 20 11 20 10 22 11 22 10 22 10 22 10 22 10 21 11 20 11 20 11 20 10 22 11 22 10 22 10 22 11 22 11 22 10 21 11 21 11
11 20 11 20 10 22 11 20 10 20 11 22 10 21 10 20 10 20 11 22 10 22 11 20 11 20 11 20 11 20 11 20 11 20 11 20 10 20 10 20 11 22 10 20 11 22 10 22 11 22 11 22 10 20 10 21 11 21 11 21 11 22 11 21 11 20 11 22 11 21 10 22 11 22 11 20 10 21 11 21 11 20 10 20 10 22 11 20 11 20 11 21 11 22 10 22 11 20 11 22
21 11 21 11 20 11 22 10 22 10 22 10 20 11 20 11 21 10 20 11 22 10 21 10 21 11 20 11 22 10 21 11 20 10 21 11 20 11 20 10 22 10 21 11 22 10 21 10 21 11 21 10 20 10 22 11 21 10 20 11 20 11 22 11 20 11 21 11 20 11 20 11 21 11 20 11 22 11 21 11 21 11 22 11 21 11 22 11 22 11 20 11 22 11 20 11 21 11 22 11
11 21 11 22 11 21 10 21 11 21 11 20 10 20 11 20 10 20 11 21 11 20 10 21 11 20 11 22 11 22 10 21 10 20 11 22 11 21 11 21 11 22 11 21 10 21 11 20 11 22 10 22 10 20 11 20 10 21 10 21 10 21 10 22 10 22 10 22 11 20 11 21 11 21 11 22 10 20 11 21 10 20 11 21 10 22 11 21 11 21 10 20 11 21 11 21 11 20 11 22
20 11 20 11 21 11 22 10 22 10 20 11 20 11 21 10 22 11 22 11 21 11 21 11 22 11 22 11 22 11 22 11 22 11 21 11 22 11 20 11 20 11 20 10 21 10 21 11 22 11 20 11 21 11 22 10 22 11 21 11 20 10 21 11 22 11 21 11 21 11 22 11 21 11 20 11 22 10 22 11 21 10 22 11 21 11 20 11 20 11 21 11 22 11 20 11 22 11 20 11
